abel/abelian | アーベル | 
additive category | 加法圏 | 加性範疇/加法範疇
adjoint (functor) | 随伴ずいはん | 伴隨(函子)
affine | アフィン | 仿射
algebra | 代数 | 代數
associative | 結合 | 結合
bilinear　| 双線型　そうせんけい | 雙線型
bimodule　| 両側加群　りょうがわかぐん | 雙模
category　| 圏　けん | 範疇
categorification　| 圏化　けんか | 範疇化
chain | チェイン | 鏈
class | 類るい | 類
cluster　| 団　だん / クラスター | 叢
co (prefix) | 余よ | 余 / 上
cobordism | | 配邊
coefficient　| 係数　けいすう | 係數
coherent　sheaf　| 連接層 | 凝聚層
cohomology　| コホモロジー | 上同調
combinatorics | 組合せ | 組合
commutative　| 可換（的な） | 交換
complex | 複体 | 複型
composition　| 合成　| 複合
conjugation | 共役 きょうやく | 共軛
correspondence | 対応　| 對應
cover | 被覆 | 覆蓋
cyclic | 巡回 じゅんかいぐん | 循環
decomposable | 直可約 ちょくかやく |  可分解
derived (category/functor)　| 導来　どうらい | 導/導出
determinant | 行列式 | 行列式
differentiate/differential　| 微分 | 微分
dimension | 次元 | 維
direct　sum　| 直和 | 直和
duality | 双対 そうつい | 對偶
element　| 元　| 元素
endomorphism | 自己準同型 | 自同態
envelope | 包絡 ほうらく | 包絡
epimorphism　| 全射　エピ射 | 滿射
equivalence | 同値 どうち| 等價
exact | 完全かんぜん | 正合
exchange | 交換 | 交換
faithful (functor) | 忠実関手 | 忠實(函子)
field | 体 | 域
finite | 有限　| 有限 
foliation | 葉層構造 | 葉狀結構
full (functor) | 充満関手 | 完全/滿(函子)	
function | 関数 かんすう | 函數
functor | 関手かんしゅ | 函子
geometry　| 幾何 | 幾何
generate | 生成 | 生成
group | 群 | 群
hereditary | 遺伝　いでん | 遺傳
homology | ホモロジー | 同調
homomorphism | (準同型)写像 | 同態/態射
homotopy | ホモトピー | 同倫
ideal | イデアル | 理想
identity element | 単位元たんいげん | 單位元
identity morphism | 恒等射 | 單位元
image | 像 | 像
indecomposable | 直既約 ちょくきやく | 不可分解
inverse | 逆/反転 | 逆
isomorphism | 同型(写像) | 同構
kernel | 核 | 核
knot | 結び目 | 紐結
linear | 線型 (rarely: 一次) | 線性
manifold　| 多様体　たようたい | 流形
map | 写像 | 映射
matrix | 行列ぎょうれつ　| 矩陣
minor | 小行列式 | 余子式
module | 加群　かぐん　| 模
moduli space | モジュライ空間 | 模空間
monoid | モノイド　(sometimes: 単系 たんけい) | 么半群
monomial | 単項式 たんこうしき | 單項式
monomorphism　| モノ射、単射 | 單射
morphism　| 射　しゃ　/ モルフィズム　|  態射
mutation | 突変/変異 | ? 
natural transformation | | 自然變換
object | 対象 | 物件/對象
order | 位数 | 階
path algebra | 道代数 | 路代數
poset | 半順序集合 | 半偏序集合
phase | 位相 | 相
polynomial | 多項式 | 多項式
pre (prefix) | 前ぜん | 預
projective module | 射影加群 | 投射模
projective variety | 射影多様体 | 射影簇
quasi (prefix) | 準 | 擬
quiver | 箙 えびら | 箭/箭圖
regular | 正則 | 
representation　| 表現ひょうげん | 表示
ring | 環 | 環
scalar　| スカラー | 標量/常數
scheme | スキーム | 概形
semi (prefix) | 半 | 半
sequence | 系列 けいれつ | 列
set | 集合 | 集合
sheaf (faisceau)　| 層　そう | 層
simple module | 単純加群 | 單模
skew-symmetric | 歪対称 | 斜對稱
symmetric | 対称 | 對稱
symplectic | シンプレクティック | 辛
tensor product　| テンソル積 | 張量積
tilting | 傾 | 傾斜
topology　| トポロジー/位相幾何 | 拓樸
topological space　| 位相空間　いそうくうかん | 拓樸空間
universal | 普遍 | 泛
variable　| 変数　| 變數
variety | 代数多様体 | (代數)簇/多樣體
vector　| ベクトル　| 向量